@@@@@@@@@---*---@@@@@@@@@@@

@@@@@@@@@-------@@@@@@@@@@@

@@@@@@@@@-------@@@@@@@@@@@

@@@@@@@@@-------@@@@@@@@@@@

@@@@@@@@@-------@@@@@@@@@@@

@@@@@@@@@-------@@@@@@@@@@@

@@@@@@@@@-------@@@@@@@@@@@

@@@@@@@@@-------@@@@@@@@@@@

@@@@@@@@@-------@@@@@@@@@@@

@@@@@@@@@-------@@@@@@@@@@@

@@@@@@@@@-------@@@@@@@@@@@

@@@@@@@@@-------@@@@@@@@@@@

@@@@@@@@@-------@@@@@@@@@@@

@@@@@@@@@-------@@@@@@@@@@@

@@@@@@@@@-------@@@@@@@@@@@

@@@@@@@@@-------@@@@@@@@@@@

@@@@@@@@@-------@@@@@@@@@@@

@@@@@@@@@-------@@@@@@@@@@@

@@@@@@@@@-------@@@@@@@@@@@

@@@@@@@@@-------@@@@@@@@@@@

@@@@@@@@@-------@@@@@@@@@@@

@@@@@@@@@-------@@@@@@@@@@@

@@@@@@@@@-------@@@@@@@@@@@

@@@@@@@@@-------@@@@@@@@@@@

@@@@@@@@@-------@@@@@@@@@@@

@@@@@@@@@-------@@@@@@@@@@@

@@@@@@@@@---&---@@@@@@@@@@@