*----#----
------#---
----#-----
------#---
-----#----
----#-----
-----#----
--------#-
--#-------
---------&

