*---------
-----#----
----------
----------
----------
-----#----
--#-------
----------
-----#----
---------&