@@@@*@@@@@@@@@@@@@@
@@@@-@@@@@@@@@@@@@@
@@@@-@@@@@@@@@@@@@@
@@@@-@@@@@@@@@@@@@@
@@------@@@@@@@@@@@
@@------@@@@@@@@@@@
@@------@@@@@@@@@@@
@@------@@@@@@@@@@@
@@------@@@@@@@@@@@
@@------@@@@@@@@@@@
@@------@@@@@@@@@@@
@@------@@@@@@@@@@@
@@------@@@@@@@@@@@
@@------@@@@@@@@@@@
@@@@@-@@@@@@@@@@@@@
@@@@@-@@@@@@@@@@@@@
@@@@@-@@@@@@@@@@@@@
@@@@@&@@@@@@@@@@@@@
