#############
#############
##----*----##
##---------##
##---------##
##---------##
##---------##
##---------##
##---------##
##---------##
##---------##
######&######
#############
