#########---*---###########
#########-------###########
#########-------###########
#########-------###########
#########-------###########
#########-------###########
#########-------###########
#########-------###########
#########-------###########
#########-------###########
#########-------###########
#########-------###########
#########-------###########
#########-------###########
#########-------###########
#########-------###########
#########-------###########
#########-------###########
#########-------###########
#########-------###########
#########-------###########
#########-------###########
#########-------###########
#########-------###########
#########-------###########
#########-------###########
#########---&---###########