@@@---*@@@
@@@----@@@
@@@----@@@
@@@----@@@
@@@----@@@
@@@----@@@
@@@----@@@
@@@----@@@
@@@----@@@
@@@&---@@@
